XXXXXXXXXXXXXXXXXXXXXXXXXXXXXXXXXXXXXXXXXXXXXXXXXX
XXXXXXX                              XXXXXXXX XXXX
XXXXXXX XXXXXXXXXXXXXX XXXXXXXXXXXXX XXXXXXXX XXXX
XXXXXXX XXXXXXXXXXXXXX XXX         X XXX      XXXX
        XXXXXXXXXXXXXX XX  XXXXXXXXX XXX XXXX XXXX
XXXXXXX XXX         XX X  XXXXXXXX       XXXX XXXX
XXXXXXX XXX XXXXXXXXXX X XXXXXXXXXXXXXXXXXXXX XXXX
XXXXXXX XXX XX                      XXXXXXXXX XXXX
XXXXXXX XXX XX XXXX XXXXXXXXXXXXXXXXXXXXXXXXX XXXX
X X     XXX XX XXXX XXXX     XXXXXXXXXXXXXXXX XXXX
X X XXX     XXXXXXX XXXX XXX XXXXXXXXXXXXXXXX XXXX
X   XXXXXXX XXXXXXXXXXXX XXX XXXXXX XXXXXXXXX XXXX
XXXXXXXXXXX XXXXXXXXXXXX XXX XXXXXX XXXXXXXXX XXXX
XXXXXXXXXXX              XXX XX         XXXXX XXXX
XXXXXXXXXXX XXXXXXXXXXXXXXXX XX XXX XXXXXXXXX XXXX
XXXX        XXXXXXXXX        XX XX  XXXXXXXXX XXXX
XXXXXXX XXXXXXXXXXXXX XXXXXXXXX XX XXXXXXXXXXXXXXX
XXXXXXX XXXXXXXXXXXXX           XX                
XXXXXXX XX    XXXXXXXXXXXXXXX XXXXXXXXXXXXXXXXXXXX
XXXXXXX XX XX XX XXXXXXXXXXXX XXXXXXXXXXXXXXXXXXXX
XXXXXXX    XX    XXXXXXXXX    XXXXXXXXXXXXXXXXXXXX
XXXXXXXXXXXXXXXXXXXXXXXXXXXXXXXXXXXXXXXXXXXXXXXXXX