XXXXXXXXXXXXXXXXXXXXXXXXXXXX
XXXX              XXXXXXXXXX
     XXXXXXXX XXXXXXXXXXXXXX
XXXX XXXXXXXX XXXXXXXXXXXXXX
X    XXXXXXXX              X
X XXXXXX XXXXXXXXXXXXX XXXXX
X          XX             XX
XXXXXXXXXXXXX XXXXXXXXXXXXXX
XXXXXX        XXXX      XXXX
XXXXXXXXXXXXX      XXXX XXXX
XXXX     XXXX XXXXXXXXX XXXX
XXXXXXXX XXXX XXXXXXXXX     
XXXXXXXX      XXXXXXXXXXXXXX
XXXXXXXXXXXXXXXXXXXXXXXXXXXX
